20 8
00000000000000001111
00011110000000000001
00000000000000000001
00000000000000111001
00000000000000000000
00001110000001110000
00000000000000010300
00000000000000010000